R 800 600
NO ./imgs/bluestone.xpm
SO ./imgs/colorstone.xpm
WE ./imgs/mossy.xpm  
EA ./imgs/eagle.xpm
S ./imgs/barrel.xpm
F 255,175,125
C 125,125,255

1111111111111
1222222222221
1222222222221
1222222222221
1222222222221
111111N111111
     111
