R 800 600
NO ./imgs/bluestone.xpm
SO ./imgs/colorstone.xpm
WE ./imgs/mossy.xpm    
EA ./imgs/eagle.xpm
S ./imgs/barrel.xpm
F 255,175,125
C 125,125,255

1111111111111
1000002000001
1000000000001
1000000000001
1111111111101
          101
        1110111111111111111111111
        100000002211000000000000111
        10110000011100000020000021
        100100000000000000000000111
11111111101100000111000000N000001
100000000011000001110111111111111
1111100111111011100000010001
    1011  111111111111111111
11111011
10000001111111111111111111111
10002000000000000001000000001
110000011101010111000111100111
11110111 1110101 101111010001
11111111 1111111 111111111111
