R 800 600
NO assets/imgs/textures/wall1a.png
SO assets/imgs/textures/wall1b.png
WE assets/imgs/textures/wall2a.png   
EA assets/imgs/textures/wall2b.png
F assets/imgs/textures/floor.png
C assets/imgs/textures/ceiling.png
S1 assets/imgs/sprites/table.png
S2 assets/imgs/sprites/pillar.png
S3 assets/imgs/sprites/battery.png
S4 assets/imgs/sprites/food.png
S5 assets/imgs/textures/galaxy.png

1111111111111
1000002000001
1E00000000001
1000005000001
1111111111H11
        10001
        11H1111111111111111111111
        100I000003110000000000001
        102100000113000000200000111
        1001002000I0000000000000I01
11111111101100000113000000050000101
13000000001100005111H11111111111101
1111100111111411140I000000000000001
    1H11  111111111111111111H111111
11111011                   101
1000000111111111111111111111H1
105020000000000000010000000001
110000011101010111000111100111
11113111 1114101 131111010051
11111111 1111111 111111 11111
 